State,County,REP votes,DEM votes,IND votes,Total votes,REP/DEM
Georgia,Jasper County,4353,1544,119,6016,REP
Georgia,Dodge County,5021,1836,138,6995,REP
Georgia,Clarke County,12691,29514,2016,44221,DEM
Georgia,Carroll County,29983,12422,1339,43744,REP
Georgia,Wilkes County,2569,1844,57,4470,REP
Georgia,Pike County,7273,1239,163,8675,REP
Georgia,Tattnall County,5092,1678,109,6879,REP
Georgia,Baker County,775,650,15,1440,REP
Georgia,Wayne County,8147,2039,190,10376,REP
Georgia,Pulaski County,2436,1104,58,3598,REP
Georgia,Schley County,1472,401,36,1909,REP
Georgia,Camden County,12287,5914,624,18825,REP
Georgia,Burke County,4491,4730,129,9350,DEM
Georgia,Treutlen County,1808,860,32,2700,REP
Georgia,Putnam County,6516,2745,170,9431,REP
Georgia,Heard County,3370,743,93,4206,REP
Georgia,Candler County,2661,1023,73,3757,REP
Georgia,Crawford County,3632,1419,106,5157,REP
Georgia,Bleckley County,3717,1094,123,4934,REP
Georgia,Seminole County,2343,1186,48,3577,REP
Georgia,Grady County,6047,3005,135,9187,REP
Georgia,Lincoln County,2759,1271,70,4100,REP
Georgia,Lumpkin County,9613,2216,495,12324,REP
Georgia,Long County,2623,1356,130,4109,REP
Georgia,Forsyth County,69801,23427,4086,97314,REP
Georgia,Thomas County,11225,7138,367,18730,REP
Georgia,Walker County,18938,4213,788,23939,REP
Georgia,Quitman County,575,461,8,1044,REP
Georgia,Calhoun County,829,1178,16,2023,DEM
Georgia,Liberty County,6125,9531,426,16082,DEM
Georgia,Mitchell County,4272,3492,93,7857,REP
Georgia,Gwinnett County,146463,165063,12405,323931,DEM
Georgia,Talbot County,1196,2001,46,3243,DEM
Georgia,Early County,2552,2165,65,4782,REP
Georgia,Union County,9849,1962,228,12039,REP
Georgia,McIntosh County,3482,2298,113,5893,REP
Georgia,Rockdale County,13463,23206,920,37589,DEM
Georgia,Clayton County,11740,75908,1588,89236,DEM
Georgia,Columbia County,43060,18863,2267,64190,REP
Georgia,Lee County,10641,3166,299,14106,REP
Georgia,Jones County,8304,3960,260,12524,REP
Georgia,Lanier County,1984,805,72,2861,REP
Georgia,Houston County,35351,22460,1748,59559,REP
Georgia,Jeff Davis County,4102,901,86,5089,REP
Georgia,Glascock County,1235,138,17,1390,DEM
Georgia,Haralson County,9579,1474,264,11317,REP
Georgia,Dade County,5047,965,226,6238,REP
Georgia,Baldwin County,7691,7965,419,16075,DEM
Georgia,Chatham County,43649,58998,3366,106013,DEM
Georgia,Bartow County,29879,8204,1180,39263,REP
Georgia,Emanuel County,5330,2433,75,7838,REP
Georgia,Coweta County,42513,16572,2230,61315,REP
Georgia,Jefferson County,3057,3809,68,6934,DEM
Georgia,Wilcox County,2096,852,25,2973,REP
Georgia,Stephens County,7682,1835,243,9760,REP
Georgia,Oglethorpe County,4622,1829,199,6650,REP
Georgia,Clinch County,1724,685,34,2443,REP
Georgia,Berrien County,5408,1041,114,6563,REP
Georgia,Catoosa County,20860,4769,881,26510,REP
Georgia,Toombs County,6612,2338,158,9108,REP
Georgia,Elbert County,5269,2507,136,7912,REP
Georgia,Worth County,6144,2015,107,8266,REP
Georgia,Johnson County,2519,1136,27,3682,REP
Georgia,Brantley County,5561,619,105,6285,DEM
Georgia,Barrow County,21105,6580,1143,28828,REP
Georgia,Montgomery County,2668,847,45,3560,REP
Georgia,Appling County,5492,1434,77,7003,REP
Georgia,Banks County,6130,684,132,6946,DEM
Georgia,Floyd County,24045,9127,1078,34250,REP
Georgia,Rabun County,6287,1443,219,7949,REP
Georgia,Sumter County,5275,5520,178,10973,DEM
Georgia,Pickens County,11651,1977,354,13982,REP
Georgia,Effingham County,17865,4851,679,23395,REP
Georgia,Henry County,45641,49902,2494,98037,DEM
Georgia,Coffee County,9575,4090,231,13896,REP
Georgia,Bacon County,3356,607,47,4010,REP
Georgia,Lamar County,5183,2267,125,7575,REP
Georgia,Telfair County,2449,1313,32,3794,REP
Georgia,Murray County,10340,1799,283,12422,REP
Georgia,Oconee County,12885,5253,892,19030,REP
Georgia,Brooks County,3679,2504,85,6268,REP
Georgia,Macon County,1540,2705,42,4287,DEM
Georgia,Jenkins County,1892,1108,34,3034,REP
Georgia,Echols County,1006,156,13,1175,REP
Georgia,Butts County,6717,2566,194,9477,REP
Georgia,Peach County,5405,5083,211,10699,REP
Georgia,Spalding County,15636,9347,957,25940,REP
Georgia,Cobb County,152602,159416,14406,326424,DEM
Georgia,Dooly County,1941,1860,35,3836,REP
Georgia,Gordon County,15171,3176,503,18850,REP
Georgia,Harris County,11931,4082,379,16392,REP
Georgia,Marion County,1921,1213,49,3183,REP
Georgia,Monroe County,8821,3570,284,12675,REP
Georgia,White County,9751,1672,348,11771,REP
Georgia,Muscogee County,26901,39602,1817,68320,DEM
Georgia,Franklin County,7054,1243,177,8474,REP
Georgia,Charlton County,2950,1004,54,4008,REP
Georgia,Colquitt County,9892,3460,240,13592,REP
Georgia,Douglas County,24803,30971,1591,57365,DEM
Georgia,Glynn County,21482,11738,821,34041,REP
Georgia,Madison County,9195,2423,327,11945,REP
Georgia,Tift County,8680,3892,224,12796,REP
Georgia,Wheeler County,1421,646,35,2102,REP
Georgia,McDuffie County,5432,3699,137,9268,REP
Georgia,Twiggs County,2034,1970,49,4053,REP
Georgia,Ware County,8508,3436,206,12150,REP
Georgia,Paulding County,44646,18004,1951,64601,REP
Georgia,Bryan County,10513,4010,540,15063,REP
Georgia,Habersham County,13184,2483,461,16128,REP
Georgia,Laurens County,12401,6737,310,19448,REP
Georgia,Jackson County,21754,4469,834,27057,REP
Georgia,Bibb County,22589,34383,1355,58327,DEM
Georgia,Cherokee County,80611,25203,5011,110825,REP
Georgia,Fannin County,9622,1920,222,11764,REP
Georgia,Chattahoochee County,746,593,45,1384,REP
Georgia,Chattooga County,6457,1612,177,8246,REP
Georgia,Miller County,1888,622,30,2540,REP
Georgia,Taliaferro County,349,545,3,897,DEM
Georgia,Whitfield County,21514,7925,923,30362,REP
Georgia,Screven County,3305,2300,94,5699,REP
Georgia,Washington County,4138,4187,97,8422,DEM
Georgia,Polk County,11006,2863,289,14158,REP
Georgia,Terrell County,1872,2267,40,4179,DEM
Georgia,Warren County,991,1313,28,2332,DEM
Georgia,Newton County,20907,21936,944,43787,DEM
Georgia,Greene County,5488,3194,149,8831,REP
Georgia,Turner County,2094,1243,53,3390,REP
Georgia,Atkinson County,1873,696,35,2604,REP
Georgia,Clay County,566,697,8,1271,DEM
Georgia,Fulton County,110372,281875,14926,407173,DEM
Georgia,Hancock County,841,2695,36,3572,DEM
Georgia,Morgan County,6559,2658,218,9435,REP
Georgia,Richmond County,24441,48707,1804,74952,DEM
Georgia,Towns County,5377,1206,143,6726,REP
Georgia,Walton County,31093,8279,1053,40425,REP
Georgia,Webster County,630,471,13,1114,REP
Georgia,Wilkinson County,2332,1893,51,4276,REP
Georgia,Fayette County,35034,23255,2098,60387,REP
Georgia,Taylor County,2062,1295,45,3402,REP
Georgia,Crisp County,4539,2835,126,7500,REP
Georgia,Bulloch County,14476,8812,863,24151,REP
Georgia,Ben Hill County,3734,2098,91,5923,REP
Georgia,Cook County,4175,1752,111,6038,REP
Georgia,Evans County,2404,1130,68,3602,REP
Georgia,Decatur County,6009,4104,125,10238,REP
Georgia,Stewart County,805,1220,28,2053,DEM
Georgia,Hart County,7285,2583,209,10077,REP
Georgia,Randolph County,1270,1597,28,2895,DEM
Georgia,Upson County,7288,3471,165,10924,REP
Georgia,Pierce County,6301,903,93,7297,REP
Georgia,Meriwether County,5216,3800,165,9181,REP
Georgia,DeKalb County,47531,239131,9209,295871,DEM
Georgia,Dougherty County,10227,23224,474,33925,DEM
Georgia,Troup County,15643,9597,553,25793,REP
Georgia,Lowndes County,21308,14614,891,36813,REP
Georgia,Hall County,51681,16153,2299,70133,REP
Georgia,Gilmer County,10465,1955,293,12713,REP
Georgia,Irwin County,2711,890,58,3659,REP
Georgia,Dawson County,9880,1444,356,11680,REP
